#######
#P    #
### # #
#  #  #
# ### #
#E    #
#######
