####################
#P  #       #      #
# # # ##### # #### #
# # #     #   #    #
# ##### ### # #### #
#     #     #      #
##### ### ### #### #
#   #     #        #
# # ####### ###### #
###########E########
