####################
#P                 #
# # # ##### # #### #
# # #     # # #    #
# ##### ### # ######
#     #            #
##### ### ### #### #
#   #       ###### #
# # #######      # #
# #         # ## # #
# ########### ## # #
#   #       #      #
### # ##### ##### ##
#   #       #      #
# ##### ### # ######
#       #   #      #
####### ##### ######
#E                ##
####################
